0    0    0    0    0  -10    0    0    0    0
0    0   -1   -1    0    0    0    0    0   20
0    0  -10    0    0    0  -10    0    0    0
0    0    0    0    0    0   -5   -5   -5    0
0    0    0    0    0    0    0   -5    0    0
0    0    0    0    0    0    0    0    0    0
0   -5   -5    0    0   -1   -1    0   -2   10
0    0    0    0    0   -1   -1    0    0   10
